111111111
110C00C01
1P10CCC11
1E00000C1
1CCC00001
111111111