111111111111111111111111111111111111111111
1C0000000000001000000011111111111111111111
1000000000000000000C0011111111111111111111
11011100H0111100C0000011111111111111111111
1E00000000111100000F0011111111111111111111
111111110H01110000000011111111111111111111
100000000000010000000011111111111111111111
10C000000000010000000011111111111111111111
11011100H0111100000C0011111111111111111111
10000000000C0000P0000011111111111111111111
111111111111111111111111111111111111111111